################################
#                         #    #
#                         #    #
#    #                    #    #
###  #########      #######    #
#    #                         #
#    #         #   #           #
#    #                    #    #
#    #                    #    #
#        ###   #   #  ##########
#        #            #        #
####     #            #    #   #
#        #            #    #####
#                              #
#                              #
####     #      S              #
#        #           ##    #####
#        #           ##    #   #
#                          #   #
#     #####              ###   #
#         #                    #
#         #                    #
#         #        ###   ###   #
#                  #       #   #
#    #  #  #  #    #       #####
#                              #
#                              #
#    ##############        #   #
#                          #####
#                              #
#                              #
################################
