###@@##@@#####@#@@#@@####@###@##
#             ####             @
#                              @
@  #@@@#@@@                    @
@  @      #  #    #    @       @
#  #      #  @    @    #       @
@  #  ##  #            @       @
@  @  ##  #            @#@#@@##@
#  #      @                    #
@  @      @  #    #            #
@                              @
@                              @
@   #@  @@           #@   @@   @
#   @#  ##           @@   #@   #
#                              @
#                              @
@                              @
#                              #
#   @#  #@           @@   #@   @
#   @#  ##           ##   @#   #
#                              @
#                              #
@  @   @   #        #          @
#                      #@@#@@  @
@                              @
#  #   #   #        #          #
#          @        #  #@@#    @
#          #@#    #@#          @
@  @   @     @    @            #
@            #    @        @   @
@            #    #        #   #
#@@#@#@#@@#@@@@#@@@#######@@####