@@##@######@###@@#@@@@@@@@####@@
#           #        @         #
@           #        @         #
#  @@  ##   #        @#######  #
@  ##  @@   #                  #
@                              @
@                    @#@@####  @
##@##@@###              @@     #
@                       ##     @
@                              @
#     @@#                   #  #
@                     #@   ##  @
#                     #        #
#                              #
#                              #
#             S                #
#                              #
@                              @
@                              @
#        #             #       #
#        #             @       #
#        #             @       @
@######@@#         @@  @##@@##@@
@                  #@  @       #
#                      @       #
#     #                @       #
#     @                @       #
@  @     @             #       #
@  @     #                   #@@
#                  @#       ###@
@                  @#       #@##
@@#@#@@#@@@###@#@#####@###@@@@#@