@@@@@##@#@@@##@@##@@##@@##@##@#@
#@##   #      #                #
##@    @      @   @@           #
#@     #      #   #         ##@@
@#     @#    #@         #   #  #
#                    @  @   @  @
@                    #  #   @  @
#  ##  ##            @  #      #
#      #     #@  @#  #         @
#                              #
#                        @@    @
#  @   @@                #     @
#  ##  @@                      #
#                              #
@                         @    @
#  @@   #     S      @   ##    @
#  #@  @#            #         #
#                    #         #
#                    @         #
#         @                @   @
#                          ###@@
@#@@#                 ##      #@
#   #   #  #  @  #    ##       @
#                              @
@                              @
@#@@@@@#@#     ###@##    #     #
#        @#@####         @     @
@                        @     #
@                        #     #
@                        #    #@
@@##                     #   #@#
#@@@#@@@#@#@#@@@#@@#@@####@@@@#@